********************
*------------------*
*-A----------------*
*---------------P--*
*------W----------->
*-------------W----*
*---------O--------*
*---W--------------*
*------------------*
*********v**********