********************
*------W-----------*
*-A----------------*
*---------------P--*
<------------------*
*------------------*
*------------------*
*------W-----------*
*----------------W-*
****************v***