********************
*------W-----------*
*-A----------------*
*------------------*
<------------------*
*----------------W-*
*------------------*
*------W-----------*
*------------------*
****************v***