********************
*------------------*
*------------------*
*------------------*
<------------------*
*------------------*
*------------------*
*------------------*
*------------------*
****************v***