****************^***
*------------------*
*------------------*
*------------------*
*------------------*
*------------------*
<------------------*
*------------------*
*------------------*
********************