****************^***
*------------------*
*-A----------------*
*------------------*
*----------W-----W-*
*------------------*
<------------------*
*--------------W---*
*------------------*
********************