*********^**********
*------------------*
*--------------A---*
*------------------*
*--W---------------*
*------------------*
*---------W-------->
*--W---------------*
*------------------*
********************