*********^**********
*------------------*
*------------------*
*------------------*
*------------------*
*------------------*
*------------------>
*------------------*
*------------------*
********************